VISADA JAUNA Для мужчин рубашки Европа Размеры Новые поступления Slim Fit 
мужской рубашка с длинными рукавами Британский стиль хлопок Для мужчин рубашка n332


Характеристики товара

    Бренд: VISADA JAUNA
    Пол: Мужчины
    Тип товара: Рубашки
    Воротник: Отложной воротник
    Вид застежки: Однобортный
    Стиль рукава: Обычный
    Тип рубашки: Повседневные рубашки
    Длина рукава: Полная
    Материал: Полиэстер,Хлопок
    Артикул: N332 Men Shirt
    Паттерн: Сплошной
    Тип ткани: Шелковая ткань в рубчик
    Форма: Повседневный
    Product Shape: Men Shirt
    Fit: Tailored
    Fastening: Button Through
    Color: White;Black;Light blue;Navy
    Size: S/M/L/XL/XXL
    Fabric Content: Cotton;Polyester
    Season: Spring;Summer;Autumn;Winter
    Collocation: Pants;Shorts;Suits;Jackets;Coats
    Description: Men Casual Long Sleeve Cotton Shirt
    Style: Fashion;Social;Casual;Dress Shirts


Упаковка

    Единица измерения: шт.
    Вес посылки: 0.32kg (0.71lb.)
    Размер посылки: 25cm x 15cm x 5cm (9.84in x 5.91in x 1.97in)

